################
#00222222222222#
#02222222222222#
#2222222222#222#
#222222222222F2#
#######22222222#
#2222222222#222#
#22222222222222#
################