################
#00000000000000#
#00000002200000#
#0000000000#000#
#002000000000F0#
#######00000000#
#0000000200#000#
#00000000000000#
################