################
#00000000000000#
#00000000000000#
#0000000000#000#
#00000000000000#
#######00000000#
################
################
################