################
#00000000000000#
#00000002200000#
#0000000000#000#
#00200000000000#
#######00000000#
################
################
################