################
#00000000000000#
#00000000220000#
#0000000000#000#
#00000000000000#
#######00000200#
#000F000000#000#
#FFFF0020000000#
################